00000000000000000000
00000000000000000000
00000000000000000000
00000000000000000000
00000000022200000000
00000000024200000000
00000022223200000000
00000024165222000000
00000022231342000000
00000000212222000000
00000000242000000000
00000000222000000000
00000000000000000000
00000000000000000000
00000000000000000000
00000000000000000000
00000000000000000000
00000000000000000000
00000000000000000000
00000000000000000000