00000000000000000000
00000000000000000000
00000000000000000000
00000000000000000000
00000000000000000000
00000000000000000000
00000022222222200000
00000021122111200000
00000021113111200000
00000023122213200000
00000021244421200000
00000221244421220000
00000213113113120000
00000211111211520000
00000222222222220000
00000000000000000000
00000000000000000000
00000000000000000000
00000000000000000000
00000000000000000000