00000000000000000000
00000000000000000000
00000000000000000000
00000000000000000000
00000000000000000000
00000000000000000000
00000000222222000000
00000000211112000000
00000022233312000000
00000025134412000000
00000021344422000000
00000022221120000000
00000000022220000000
00000000000000000000
00000000000000000000
00000000000000000000
00000000000000000000
00000000000000000000
00000000000000000000
00000000000000000000