00000000000000000000
00000000000000000000
00000000000000000000
00000000000000000000
00022222222222200000
00024411211111222000
00024411213113112000
00024411232222112000
00024411115122112000
00024411212113122000
00022222212231312000
00000213113131312000
00000211112111112000
00000222222222222000
00000000000000000000
00000000000000000000
00000000000000000000
00000000000000000000
00000000000000000000
00000000000000000000