00000000000000000000
00000000000000000000
00000000000000000000
00000000000000000000
00000000000000000000
00000000000000000000
00000022222220000000
00000024141420000000
00000021333120000000
00000024353420000000
00000021333120000000
00000024141420000000
00000022222220000000
00000000000000000000
00000000000000000000
00000000000000000000
00000000000000000000
00000000000000000000
00000000000000000000
00000000000000000000