00000000000000000000
00000000000000000000
00000000000000000000
00000000000000000000
00000000000000000000
00000000000000000000
00000022222200000000
00000221111220000000
00000213133120000000
00000244444420000000
00000213313120000000
00000222152220000000
00000002222000000000
00000000000000000000
00000000000000000000
00000000000000000000
00000000000000000000
00000000000000000000
00000000000000000000
00000000000000000000