00000000000000000000
00000000000000000000
00000000000000000000
00000000000000000000
00000000000000000000
00000000000000000000
00000002222222200000
00000002111122200000
00000002131111200000
00000222131221200000
00000244413111200000
00000244432312200000
00000222212131200000
00000000211151200000
00000000222222200000
00000000000000000000
00000000000000000000
00000000000000000000
00000000000000000000
00000000000000000000