00000000000000000000
00000000000000000000
00000000000000000000
00000000000000000000
00000000000222220000
00000000000211120000
00022222222212120000
00021313131311120000
00021242424213220000
00024444444151200000
00021212121232220000
00021313131311120000
00022222222212120000
00000000000211120000
00000000000222220000
00000000000000000000
00000000000000000000
00000000000000000000
00000000000000000000
00000000000000000000