00000000000000000000
00000000000000000000
00000000000000000000
00000000000000000000
00000000000000000000
00000000000000000000
00000022222222200000
00000021112111200000
00000021333331200000
00000221313131200000
00000213115111200000
00000213122221220000
00000211244444120000
00000221144444120000
00000022222222220000
00000000000000000000
00000000000000000000
00000000000000000000
00000000000000000000
00000000000000000000