00000000000000000000
00000000000000000000
00000000000000000000
00000000000000000000
00000000000000000000
00000022222220000000
00000021544420000000
00000021111122000000
00000222311112000000
00000211111112000000
00000213123212000000
00000211121112000000
00000222222222000000
00000000000000000000
00000000000000000000
00000000000000000000
00000000000000000000
00000000000000000000
00000000000000000000
00000000000000000000