00000000000000000000
00000000000000000000
00000000000000000000
00000000000000000000
00000000000000000000
00000000000000000000
00000222222200000000
00000244441200000000
00002224443222000000
00002113231312000000
00002133112312000000
00002111121112000000
00002222151222000000
00000002222200000000
00000000000000000000
00000000000000000000
00000000000000000000
00000000000000000000
00000000000000000000
00000000000000000000