00000000000000000000
00000000000000000000
00000000000000000000
00000000000000000000
00000000000000000000
00000000000000000000
00000022222220000000
00000024434420000000
00000024424420000000
00000021333120000000
00000021131120000000
00000021333120000000
00000021125120000000
00000022222220000000
00000000000000000000
00000000000000000000
00000000000000000000
00000000000000000000
00000000000000000000
00000000000000000000