00000000000000000000
00000000000000000000
00000000000000000000
00000000000000000000
00000000000000000000
00000000000000000000
00000000000000000000
00000002222220000000
00000002144420000000
00002222444420000000
00002112223122200000
00002131311331200000
00002513131111200000
00002111222111200000
00002222202222200000
00000000000000000000
00000000000000000000
00000000000000000000
00000000000000000000
00000000000000000000