00000000000000000000
00000000000000000000
00000000000000000000
00000000000000000000
00000000000000000000
00000000000000000000
00000022222222000000
00000021111112000000
00000021233112000000
00000021444212000000
00000022444312200000
00000002122131200000
00000002311311200000
00000002112115200000
00000002222222200000
00000000000000000000
00000000000000000000
00000000000000000000
00000000000000000000
00000000000000000000