00000000000000000000
00000000000000000000
00000000000000000000
00000000000000000000
00000000000000000000
00000000000000000000
00000002222200000000
00000222111222200000
00000211131311200000
00000213111315200000
00000222332222200000
00000002114420000000
00000002444420000000
00000002222220000000
00000000000000000000
00000000000000000000
00000000000000000000
00000000000000000000
00000000000000000000
00000000000000000000