00000000000000000000
00000000000000000000
00000000000000000000
00000000000000000000
00000000000000000000
00000000000000000000
00000000000000000000
00022222200022222000
00021111222021142000
00021131312024442000
00021211312221142000
00021133311131542000
00022211311321142000
00000211323124442000
00000221111121142000
00000022222222222000
00000000000000000000
00000000000000000000
00000000000000000000
00000000000000000000