00000000000000000000
00000000000000000000
00000000000000000000
00000000000000000000
00000000000000000000
00000000000000000000
00000000002222220000
00000022222411120000
00000021124422120000
00000021134411120000
00000021121421220000
00000222122321120000
00000213111133120000
00000212321121120000
00000251122222220000
00000222220000000000
00000000000000000000
00000000000000000000
00000000000000000000
00000000000000000000