00000000000000000000
00000000000000000000
00000000000000000000
00000000000000000000
00222220222200000000
00244420211222200000
00244422211311200000
00244442213113222000
00224444221113112000
00222444122131312000
00212211112113112000
00211221212221222200
00213121231131111200
00211351131111311200
00211121313313122200
00211222222112220000
00212200002222000000
00222000000000000000
00000000000000000000
00000000000000000000
