00000000000000000000
00000000000000000000
00000000000000000000
00000000000000000000
00000000000000000000
00000000022222222200
00000000021111111200
00000000021212121200
00000000021131321200
00022222221113111200
00024421122131321200
00024411122131311200
00024421122122222200
00024421213131200000
00024411111311200000
00021122251122200000
00022220222220000000
00000000000000000000
00000000000000000000
00000000000000000000