00000000000000000000
00000000000000000000
00000000000000000000
00000000000000000000
00000000000000000000
00000222222222200000
00000221111111200000
00000211123231200000
00000213311434200000
00000215222444200000
00000222222222200000
00000000000000000000
00000000000000000000
00000000000000000000
00000000000000000000
00000000000000000000
00000000000000000000
00000000000000000000
00000000000000000000
00000000000000000000