00000000000000000000
00000000000000000000
00000000000000000000
00000000000000000000
00000000000000000000
00000222220000000000
00000211520000000000
00000213320222000000
00000213120242000000
00000222122242000000
00000022111142000000
00000021112112000000
00000021112222000000
00000022222000000000
00000000000000000000
00000000000000000000
00000000000000000000
00000000000000000000
00000000000000000000
00000000000000000000