00000000000000000000
00000000000000000000
00000000000000000000
00000000000000000000
00000000000000000000
00000222222200000000
00000211111222000000
00002232221112000000
00002511311312000000
00002144213122000000
00002244211120000000
00000222222220000000
00000000000000000000
00000000000000000000
00000000000000000000
00000000000000000000
00000000000000000000
00000000000000000000
00000000000000000000
00000000000000000000