00000000000000000000
00000000000000000000
00000000000000000000
00000000000000000000
00000000000000000000
00000002222200000000
00000002152220000000
00000002131120000000
00000022212122000000
00000024212112000000
00000024311212000000
00000024111312000000
00000022222222000000
00000000000000000000
00000000000000000000
00000000000000000000
00000000000000000000
00000000000000000000
00000000000000000000
00000000000000000000