00000000000000000000
00000000000000000000
00000000000000000000
00000000000000000000
00000000002222000000
00022222222112222000
00021112244444112000
00021131122444212000
00022113112221212000
00002121311211112000
00002112131121112000
00002111213112112000
00002111121312122000
00002222112131120000
00000002211213120000
00000000225211120000
00000000022222220000
00000000000000000000
00000000000000000000
00000000000000000000