00000000000000000000
00000000000000000000
00000000000000000000
00000000000000000000
00000000000000000000
00002222222222200000
00002111121111200000
00002135333331200000
00002111111111200000
00002222212222200000
00000002411200000000
00000002411200000000
00000002444200000000
00000002411200000000
00000002222200000000
00000000000000000000
00000000000000000000
00000000000000000000
00000000000000000000
00000000000000000000