00000000000000000000
00000000000000000000
00000000000000000000
00000000000000000000
00000000000000000000
00000000022222220000
00000000221121520000
00000000211123120000
00000000231131120000
00000000213221120000
00000022213121220000
00000024444411200000
00000022222222200000
00000000000000000000
00000000000000000000
00000000000000000000
00000000000000000000
00000000000000000000
00000000000000000000
00000000000000000000