00000000000000000000
00000000000000000000
00000000000000000000
00000000000000000000
00000000000000000000
00000000000000000000
00000000022222200000
00000002221111200000
00000022413221220000
00000024431311520000
00000024413131220000
00000022222211200000
00000000000222200000
00000000000000000000
00000000000000000000
00000000000000000000
00000000000000000000
00000000000000000000
00000000000000000000
00000000000000000000